Data;Descricao;Valor;Saldo
20/10/2023 11:22;Pagamento para CLARO MOVEL;-R$ 13,26;R$ 929,08
11/10/2023 00:47;Pix recebido de Nathalia Almeida Quintana;R$ 104,00;R$ 942,34
10/10/2023 23:43;Pix recebido de Alexandre Ferreira e Silva;R$ 94,29;R$ 838,34
10/10/2023 23:38;Pix recebido de Alexandre Ferreira e Silva;R$ 174,84;R$ 744,05
10/10/2023 23:18;Pix recebido de Nathalia Almeida Quintana;R$ 520,00;R$ 569,21
10/10/2023 11:57;Pagamento para BANCO XP S/A;-R$ 300,79;R$ 49,21
10/10/2023 02:06;Pix recebido de Alexandre Ferreira e Silva;R$ 350,00;R$ 350,00
